30
15
##############################
#............................#
#............................#
#............................#
#.............B..............#
#............................#
#............................#
1..........F................L#
#............................#
#............................#
#...........C................#
#..............H.............#
#............................#
#............................#
##############################