30
15
##############################
#.............H..............#
#........############........#
#........############........#
#.............B..............#
#............................#
#........############...C....#
1........############........2
#....F...############........#
#............................#
#.............B..............#
#........############........#
#........############........#
#.............H..............#
##############################