30
15
##############################
#........................H...#
#........F............F......#
#....######....H...######....#
#....######........######....#
#....######........######....#
#......B.....................#
1.............C..............2
#.....................B......#
#....######........######....#
#....######........######....#
#....######........######....#
#......F..............F......#
#.H...........B..............#
##############################