30
15
##############################
#.............F..............#
#...H....############......B.#
#........############........#
#.............B..............#
#.............H..............#
#........############........#
#...C....############........2
#........############........#
#.............B..............#
#............................#
#...H....############........#
#........############..B.....#
#.............F..............#
##############################